Textures

Layout
11111  111111  11111
11111   1111   11111
111111        111111
1111111      1111111
111111111  111111111
111111111  111111111
111111111  111111111
1111111      1111111
1        11        1
1                  1
1    1111  111111  1