Textures

Layout
1111111  11  1111111
1111111           11
1111111111111111  11
1111111111111     11
1111111111111   1111