Textures

Layout
    1  1111111111  1            
11  1    11111111  1
    11      11    11
    111           11
  111111          11
    1111111111111111
    1              
1   1       11111  
    1      11  
  111     111      1
         1111      1
1    111111111111  1