Textures

Layout
11111111111111111111
1                  
1                  
1                  
1                111
1              11111
1111111  11  1111111
111    11  11  11111
1  11          11  1
1  11  11  11  11  1
111  11  11  11  111
                   1
                   1
                   1
11111111111111111111