Textures

Collision Map (C UDLR)
2 ...X
3 ..X.

Layout
1                    2
11                   2
111                  2
1111                 2
11111                2
111111               2
11111111111111111    1
1 3                  1
1 3                 11
1 3                111
1 3              11111
1 1111111  11  1111111
1 111    11  11  11111
1 3  11          11  2
1 3  11  11  11  11  2
1 111  1111  1111  111
1
1 
1111111
11111111
111111111                
1111111111111111111111111