Textures

Layout
1    111111111111111
1                  1
1                  1
1                  1
1                  1
1                  1
1                  1
1                  1
1                   
1                   
11111               
    11              
                    
        1    1      
111111111111111   11