Textures

Layout
111111111111111111111111111     1111111
111111111111111111111111111111  1111111
                                1111111
                    1111111111111111111
                  111111111111111111111
               111111111111111111111111
           1111111111111111111111111111
                             1111111111
                                1111111
                                  11111
                                    111
                                     11
                                     11
        1                           111
111111111                           111
11111    1                          111
11111                               111
11111                               111
11111    111111111111111111111111111111