Textures

Layout
     111111111111111
     11           11
     11           11
     11           11
     111111       11
                  11
                  11
                  11
         11       11
        111       11
       1111       11
      11111 
     111111
    1111111      
11111111111111111111