Textures

Layout








                    11111
                    11111
1                   11111
11                  11111
111                 11111
1111111111111111111111111
1111111111111111111111111