Textures

Layout
111111111111111111111111111111111
1111                           11
1111                           11
1111                           11
1111111111111111111111         11
11111111111111111111111        11
1111111111                       
1   111111                       
1     11111111111111111111       
1       111111111111111111     11
1111     11111111111111111    111
1111                          111
1111                         1111
1111                         1111
111111111111111111111111111111111