Textures

Collision Map (C UDLR)
2 X...

Layout
111111111111111111    111111
11111111111111111      11111
11111111111111111      11111
1111111111111111        1111
1111111111111111        1111
1111111111111111  1111  111111111111111111
1111111111111111        111111111111111111
11111111111111         1111111111111111111
111111111111          11111111111111111111
1                    111111111111111111111
1               22221111111111111111111111
1                                      111
1                                      111
1    2222111111111111111111111111112222111
1                                        1
1                                        1
1    1111                              111
1    1111                              111
1    1111                              111
1111111111111                          111
1111111111111                          111
1111111111111111               11111111111
1111111111111111               11111111111
1111111111111111               11111111111
1111111111111111               11111111111
111111111111111111111111111111111111111111