Textures

Layout





         1111    1111        1111111111111111        1111111111111111        11111111111111111
        111111                                                                               1
       1111111                                                                               1
      111111111                                                                              1
     1111111111                                                                              1
    111111111111                                                                             1
   1111111111111                                                                             1
  111111111111111                                                                            1
 1111111111111111                                                                            1
1111111111111111111111111111111111111111111111111111111111111111111111111111111111111111111111