Textures

Layout
                                                                                                   11
                                                                                                   11
                                                                                                   11
                                                                                                     
                                                                                                     
1111    1111        1111111111111111        1111111111111111        11111111111111111        11111111
11111                                                                               1        11111111
11111                                                                               1        11111111
111111                                                                              1        11111111
111111                                                                              1        11111111
1111111                                                                             1        11111111
1111111                                                                             1        11111111
11111111                                                                            1        11111111
11111111                                                                            1        11111111
1111111111111111111111111111111111111111111111111111111111111111111111111111111111111        11111111