Textures

Layout
11111111111111111111
                    
                    
                    
1                  1
11                 1
111                1
1111                
11111               
111111111           
111111111111        
1111111111111111    
1111111111111111    
1111111111111111    
11111111111111111111